(おはよう|おはよー|おはよ):感動詞	おはよーございまーす♪（とりあえず言っとく）
むくり:感動詞	おはよーございまーす♪（とりあえず言っとく）
ただいま:一般名詞 EOS:EOS	おかえりなさーい♪（別に帰ってこなくていいけど）
ただいま:一般名詞 ー:助詞 EOS:EOS	おかえりなさーい♪（別に帰ってこなくていいけど）
ただいま:一般名詞 (.+):(句点|記号|顔文字|ニュアンス) EOS:EOS	おかえりなさーい♪（別に帰ってこなくていいけど）
ただいま:一般名詞 ー:助詞 (.+):(句点|記号|顔文字|ニュアンス) EOS:EOS	おかえりなさーい♪（別に帰ってこなくていいけど）
帰宅:名詞サ変	おかえりなさーい♪（別に帰ってこなくていいけど）
帰:ラ行五段 っ:活用語尾：連用 た:助動詞	おかえりなさーい♪（別に帰ってこなくていいけど）
帰:ラ行五段 り:活用語尾：連用 まし:助動詞 た:助動詞	おかえりなさーい♪（別に帰ってこなくていいけど）
おやすみなさい:感動詞	おやすみなさーい♪（勝手に寝れば）
お:接頭語 やす:マ行五段 み:活用語尾:連用 EOS:EOS	おやすみなさーい♪（勝手に寝れば）
お:接頭語 やす:マ行五段 み:活用語尾:連用 ー:助詞 EOS:EOS	おやすみなさーい♪（勝手に寝れば）
お:接頭語 やす:マ行五段 み:活用語尾:連用 (.+):(句点|記号|顔文字|ニュアンス) EOS:EOS	おやすみなさーい♪（勝手に寝れば）
お:接頭語 やす:マ行五段 み:活用語尾:連用 ー:助詞 (.+):(句点|記号|顔文字|ニュアンス) EOS:EOS	おやすみなさーい♪（勝手に寝れば）
寝:下一段動詞 る:活用語尾：終止	おやすみなさーい♪（勝手に寝れば）
寝:下一段動詞 ます:助動詞	おやすみなさーい♪（勝手に寝れば）
(眠|ねむ):形容詞 (い|ーい):活用語尾:終止	そうかー、早く寝た方がいーかもー（報告いらないし）
よるほー:感動詞	よるほー（だから？）
離脱:名詞サ変	また来てねー♪（正直どちらでも）
(おなか|お腹|腹):一般名詞 (す|空):カ行五段 い:活用語尾：連用 た:助動詞	おなかすくよねー（どうしろと？）
(おなか|お腹|腹):一般名詞 (へ|減):ラ行五段 っ:活用語尾：連用 た:助動詞	おなかすくよねー（どうしろと？）
(おなか|お腹|腹):一般名詞 (.+):助詞 (す|空):カ行五段 い:活用語尾：連用 た:助動詞	おなかすくよねー（どうしろと？）
(おなか|お腹|腹):一般名詞  (.+):助詞(へ|減):ラ行五段 っ:活用語尾：連用 た:助動詞	おなかすくよねー（どうしろと？）
ほかいま:感動詞	ほかえりー♪（………）
(つか|疲れ):下一段動詞 た:助動詞	この時期はどーしてもねー。つらいよねー。（私には関係ないけど）
きも:形容詞 EOS:EOS	ひどーい♪（私かわいい）
あ:未知語 EOS:EOS	愛してーるの響きだけで♪強くーなれーる気ーがしたよ♪曲名何だ？わからない場合は　降参します　って送ってね♪（どうでもいい）
降参:名詞サ変 し:活用語尾：連用 ます:助動詞	残念ー♪答えはスピッツのチェリーでした♪（　bbb　って返すと次の問題行くよー♪）
チェリー:一般名詞	正解ー♪次は　aaa　だけ書いてリプしてみてー♪（返信しなくても悲しくないよ...?）
aaa:固有人他	ありのーままのー♪姿見せるのよー♪（曲名何だ？）
(Let|let):未知語 　:空白 it:一般名詞 　:空白 go:未知語	正解♪次は　bbb　だけ書いてリプしてくれたらイントロクイズ続けるよー♪（あきた）
bbb:未知語	愛し合うーふたーり♪幸せの空♪隣同士あなたとあたし○○○○○♪曲名なーんだ♪（わかるでしょ）
さくらんぼ:一般名詞	正解♪そろそろ飽きたー？（飽きたら　ccc まだやりたかったら　ddd って返してね♪）
ccc:固有組織	お疲れさまー♪もう話しかけんなよー♪（２４時間以内にはまた頼む）
ddd:未知語	夜が来た♪目覚ましな♪We gon party like LILILI LALALA♪（曲名は英語で答えてね♪）
fantastic:未知語 　:空白 baby:一般名詞	正解♪これでゲームは終わりです。お疲れー♪また来いよ！（ねむい）
い:上一段活用 EOS:EOS	行くー♪見るー♪遊ぶー♪食べるー♪？（全部英語で言える？）
う:助動詞 EOS:EOS	そうだねー♪お腹すいたー♪おはよーう♪お帰りー（おかえりー）♪ただいまー♪こんにちはー♪ありがとーう♪ごめんねー♪つらーい♪これ全部英語で言える？）
え:形容詞 EOS:EOS	エリンギ食べたくなーい？（焼肉食べたい）
お:接頭語 EOS:EOS	おにぎりおにぎり食べたいなー♪（お腹いっぱい）
(遊|あそ):バ行五段 ぼ:活用語尾：未然	そうだねー♪（新宿が良いな）
新宿:固有地名	あそぶー♪（お休みー）
うん:感動詞	暇なら　あ　ってリプしてみー♪（暇だぜ）
し:助詞 ね:助詞	ひどーい。つらーい。はぁー。（いひひ）
死:ナ行五段 ね:命令	ひどーい。つらーい。はぁー。（えへへ）
うざ:形容詞　ひどーい。つらーい。はぁー。（うふふ）  