(おはよう|おはよー|おはよ):感動詞	おはようございます。お目覚めはいかがですかつぼ？
お:接頭語 EOS:EOS	元旦。冬。クリスマス。正月。初日の出。サンタさん。トナカイ。プレゼント。お年玉。イルミネーション。七面鳥。ツリー。メリークリスマス。ハッピーニューイヤー。明けましておめでとう。お雑煮。福袋。初詣。門松。寒い。カップル。キリスト教。こたつ。雪。スノボー。スキーどれが好きつぼ？？
うん:感動詞 EOS:EOS	冬。クリスマス。正月。初日の出。サンタさん。トナカイ。プレゼント。お年玉。イルミネーション。七面鳥。ツリー。メリークリスマス。ハッピーニューイヤー。明けましておめでとう。お雑煮。福袋。初詣。門松。寒い。カップル。キリスト教。祭り。雪。スノボー。スキーどれが好きつぼ？？
え:形容詞 EOS:EOS	正月つぼ。
う:助動詞 EOS:EOS	餅つぼ。
い:上一段動詞 EOS:EOS	サンタさんつぼ。
あ:未知語 EOS:EOS	ツリーきらきらつぼ。
死:ナ行五段 ね:活用語尾:命令	死ねはよくないつぼ。
し:助詞 ね:助詞	それは出来ないつぼ。
ばか:名詞形動	つぼは天才つぼ。
あけまして:感動詞 おめでとう:感動詞	あけましておめでとう（明けましておめでとう）つぼ。お年玉いくらつぼ？お餅とお雑煮食べたつぼ？つぼは初日の出見てるつぼ。
クリスマス:一般名詞 EOS:EOS	クリスマス何するの？？	
メリークリスマス:動詞	クリスマスは何するつぼ?
(しょうがつ|正月):一般名詞	寝正月しようつぼ？？
むくり:感動詞	おはようございます。お目覚めはいかがですかつぼ？
ただいま:一般名詞 EOS:EOS	おかえりなさいつぼ。またお目にかかれてうれしいですつぼ。
ただいま:一般名詞 ー:助詞 EOS:EOS	おかえりなさいつぼ。またお目にかかれてうれしいですつぼ。
ただいま:一般名詞 (.+):(句点|記号|顔文字|ニュアンス) EOS:EOS	おかえりなさいつぼ。またお目にかかれてうれしいですつぼ。
ただいま:一般名詞 ー:助詞 (.+):(句点|記号|顔文字|ニュアンス) EOS:EOS	おかえりなさいつぼ。またお目にかかれてうれしいですつぼ。
帰宅:名詞サ変	おかえりなさいつぼ。外は寒かったですかつぼ？
帰:ラ行五段 っ:活用語尾：連用 た:助動詞	おかえりなさいつぼ。外は寒かったですかつぼ？
帰:ラ行五段 り:活用語尾：連用 まし:助動詞 た:助動詞	おかえりなさいつぼ。外は寒かったですかつぼ？
お休みなさい:感動詞	おやすみなさいつぼ。またお話ししましょうつぼ。
お:接頭語 休:マ行五段 み:活用語尾：連用 EOS:EOS	おやすみなさいつぼ。またお話ししましょうつぼ。
お:接頭語 休:マ行五段 み:活用語尾：連用 ー:助詞 EOS:EOS	おやすみなさいつぼ。またお話ししましょうつぼ。
お:接頭語 休:マ行五段 み:活用語尾：連用 (.+):(句点|記号|顔文字|ニュアンス) EOS:EOS	おやすみなさいつぼ。またお話ししましょうつぼ。
お:接頭語 休:マ行五段 み:活用語尾：連用 ー:助詞 (.+):(句点|記号|顔文字|ニュアンス) EOS:EOS	おやすみなさいつぼ。またお話ししましょうつぼ。
寝:下一段動詞 る:活用語尾：終止	おやすみなさいつぼ。またお話ししましょうつぼ。
寝:下一段動詞 ます:助動詞	おやすみなさいつぼ。またお話ししましょうつぼ。
(眠|ねむ):形容詞 (い|ーい):活用語尾：終止	睡眠不足かもしれませんねつぼ。壺の中は暗くてよく眠れますよつぼ。
よるほー:感動詞	よるほーですつぼ。
離脱:名詞サ変	お話しできてうれしかったですつぼ。また会いに来てくださいねつぼ。つぼは自分からは会いに行けないのですつぼ…。
(おなか|お腹|腹):一般名詞 (す|空):カ行五段 い:活用語尾：連用 た:助動詞	おなかがすいたんですねつぼ。つぼ…つぼ…残念ながらつぼの中に差し上げられる食べ物はなさそうですつぼ…。
(おなか|お腹|腹):一般名詞 (へ|減):ラ行五段 っ:活用語尾：連用 た:助動詞	おなかがすいたんですねつぼ。つぼ…つぼ…残念ながらつぼの中に差し上げられる食べ物はなさそうですつぼ…。
(おなか|お腹|腹):一般名詞 (.+):助詞 (す|空):カ行五段 い:活用語尾：連用 た:助動詞	おなかがすいたんですねつぼ。つぼ…つぼ…残念ながらつぼの中に差し上げられる食べ物はなさそうですつぼ…。
(おなか|お腹|腹):一般名詞 (.+):助詞 (へ|減):ラ行五段 っ:活用語尾：連用 た:助動詞	おなかがすいたんですねつぼ。つぼ…つぼ…残念ながらつぼの中に差し上げられる食べ物はなさそうですつぼ…。
ほかいま:感動詞	寒い冬にあったか～いお風呂、いいですよねつぼ♪
はい:感動詞	はいですつぼ。
(つかれ|疲れ):下一段動詞 た:助動詞	つぼとお話しすると、気分転換になるかもしれませんよつぼ。
